[console_scripts]
extractcode = scancode.extract_cli:extractcode
scancode = scancode.cli:scancode

[scancode_output]
csv = formattedcode.output_csv:CsvOutput
html = formattedcode.output_html:HtmlOutput
html-app = formattedcode.output_html:HtmlAppOutput
json = formattedcode.output_json:JsonCompactOutput
json-pp = formattedcode.output_json:JsonPrettyOutput
jsonlines = formattedcode.output_jsonlines:JsonLinesOutput
spdx-rdf = formattedcode.output_spdx:SpdxRdfOutput
spdx-tv = formattedcode.output_spdx:SpdxTvOutput
template = formattedcode.output_html:CustomTemplateOutput

[scancode_output_filter]
ignore-copyrights = scancode.plugin_ignore_copyrights:IgnoreCopyrights
only-findings = scancode.plugin_only_findings:OnlyFindings

[scancode_post_scan]
copyrights-summary = scancode.plugin_copyrights_summary:CopyrightSummary
license-policy = scancode.plugin_license_policy:LicensePolicy
mark-source = scancode.plugin_mark_source:MarkSource
package-root = scancode.plugin_package:PackageRootSummarizer

[scancode_pre_scan]
ignore = scancode.plugin_ignore:ProcessIgnore

[scancode_scan]
copyrights = scancode.plugin_copyright:CopyrightScanner
emails = scancode.plugin_email:EmailScanner
info = scancode.plugin_info:InfoScanner
licenses = scancode.plugin_license:LicenseScanner
packages = scancode.plugin_package:PackageManifestScanner
urls = scancode.plugin_url:UrlScanner

